111111111111111111111111111111111111111
1000000000000000000000C00000000000000E1
100000000000000000000011111110111111101
111111111111110000000000000000000000001
110000000000000000000011111110000000001
111111C00011111111111111111111111111111
10000000000000000000000000000CCC0000001
100000000000000000000000000000000000001
111111111110111111111110111111111111111
100000000001000000000000000000000000001
111111111001000000000000000000000000001
1P0000000000000000000000000000000000001
111111111111111111111111111111111111111
